DEFAULT
17,3
keypad:54.0,12.0;note:55.0,9.0;levers:52.0,28.0;keypad-door:52.0,14.0
SSSSSSSSSSSSSSSSSSSSSSSSSSSSSSSSSSSSSSSSSSSSSSSSSSSWWWSSSSSSSSSSSSSSSSSS
SSSSSSSSSSSSSSSSSSSSSSSSSSSSSSSSSSSSSSSSSSSSSSSSSSSWEWSSSSSSSSSSSSSSSSSS
SSSSSSSSSSSSSSSSSSSSSSSSSSSSSSSSSSSSSSSSSSSSSSSSSSSWFWSSSSSSSSSSSSSSSSSS
SSSSSSSSSSSSSSSSSSSSSSSSSSSSSSSSSSSSSSSSSSSSSSSSSSSWFWSSSSSSSSSWWWWSSSSS
SSSSSSSSSSSSSSSSSSSSSSSSSSSSSSSSSSSSSSSWWWWWSSWWWSSWFWSSSWWWSSWWFFWSSSSS
SSSSSSSSSSSSSSSSSSSSSSSSSSSSSSSSSSSSSSSWFFFWWWWFWWSWFWSSWWFWWWWFFFWSSSSS
SSSSSSSSSSSSSSSSSSSSSSSSSSSSSSSSSSSSSSWWFFFFWWFFFWWWDWWWWFFFWWFFFFWSSSSS
SSSSSSSSSSSSSSSSSSSSSSSSSSSSSSSSSSSSSWWFFFFFFFFFFFFFFFFFFFFFWWFFFFWWWSSS
SSSSSSSSSSSSSSSSSSSSSSSSSSSSSSSSSSSSSWFFFFFFFFFFFFFFFFFFFFFFFFFFFFFFWSSS
SSSSSSSSSSSSSSSSSSSSSSSSSSSSSSSSSSSSSWFFFFFFFFFFFFFFFFFFFFFFFFFFFFFFWWSS
SSSSSSSSSSSSSSSSSSSSSSSSSSSSSSSSSSSSSWFFFFFFFFFFFFFFFFFFFFFFFFFFFFFFFWSS
SSSSSSSSSSSSSSSSSSSSSSSSSSSSSSSSSSSSSWFFWWFFFFFFFFFFFFFFFFFFFFWWWFFFFWWW
SSSSSSSSSSSSSSSSSSSSSSSSSSSSSSSSSSSSSWFWWWFFFFFFFFFFFFFFFFFFFFWSWFFFFFFW
SSSSSSSSSSSSSSSSSSSSSSSSSSSSSSSSSSSSSWFWWWFFFFFFFFFWWWFFFFFFFFWWWFFFFWWW
SSSSSSSSSSSSSSSSSSSSSSSSSSSSSSSSSSSSSWFFFFFFFFFFFFFWWWFFFFFFFFFFFFFFFWSS
SSSSSSSSSSSSSSSSSSSSSSSSSSSSSSSSSSSSSWWWWWWFFFFFFFFWWFFFFFFFFFFFFFFFWWSS
SSSSSSSSSSSSSSSSSSSSSSSSSSSSSSSSSSSSSSSSSSWFFFFFFFFWWFFFFWWWWFFFFFFFWSSS
SSSSSSSSSSSSSSSSSSSSSSSSSSSSSSSSSSSSSSSSSSWFFFFFFFFFFFFFWWSSWFFFFFFWWSSS
SSSSSSSSSSSSSSSSSSSSSSSSSSSSSSSSSSSSSSSSSSWWFFFWWWFFFFFFWSSSWWFFFFWWSSSS
SSSSSSSSSSSSSSSSSSSSSSSSSSSSSSSSSSSSSSSSSSSWWWFWSWWWFFFWWSSSSWFFFFWSSSSS
SSSSSSSSSSSSSSSSSSSSSSSSSSSSSSSSSSSSSSSSSSSSSWFWSSSWFFFWSSSSSWWFFFWSSSSS
SSSSSSSSSSSSSSSSSSSSSSSSSSSSSSSSSSSSSSSSSSSSSWFWWWWWFFWWSSSSSSWWFFWSSSSS
SSSSSSSSSSSSSSSSSSSSSSSSSSSSSSSSSSSSSSSSSSSSSWFFFFFFFFWSSSSSSSSWFFWSSSSS
SSSSSSSSSSSSSSSSSSSSSSSSSSSSSSSSSSSSSSSSSSSSSWWWWWWWFWWSSSSSSSSWWWWSSSSS
SSSSSSSSSSSSSSSSSSSSSSSSSSSSSSSSSSSSSSSSSSSSSSSSSSSWFWSSSSSSSSSSSSSSSSSS
SSSSSSSSSSSSSSSSSSSSSSSSSSSSSSSSSSSSSSSSSSSSSSSSSSSWFWWWWSSSSSSSSSSSSSSS
SSSSSSSSSSSSSSSSSSSSSSSSSSSSSSSSSSSSSSSSSSSSSSSSSSSWFFFFWSSSSSSSSSSSSSSS
SSSSSSSSSSSSSSSSSSSSSSSSSSSSSSSSSSSSSSSSSSSSSSSSSSSWFFFFWSSSSSSSSSSSSSSS
SSSSSSSSSSSSSSSSSSSSSSSSSSSSSSSSSSSSSSSSSSSSSSSSSSSWFFFFWSSSSSSSSSSSSSSS
SSSSSSSSSSSSSSSSSSSSSSSSSSSSSSSSSSSSSSSSSSSSSSSSSSSWFWWWWSSSSSSSSSSSSSSS
SSSSSSSSSSSSSSSSSSSSSSSSSSSSSSSSSSSSSSSSSSSSSSSSSSSWFWSSSSSSSSSSSSSSSSSS
SSSSSWWWWWWWWWWWWWWWWWWWWSSSSSSSSSSSSSSSSSSSSSSSSSSWFWSSSSSSSSSSSSSSSSSS
SSSSSWPPPPPPPPWWFFFFFFFFWSSSSSSSSSSSSSSSSSSSSSSSSSSWFWSSSSSSSSSSSSSSSSSS
WWWWWWPPPPPPPPWWFFFFFFFFWWWWWWWWWWWWWWWWWWWWWWWWWWWWFWSSSSSSSSSSSSSSSSSS
PPPPPPPPPPPPPPWWFFFFFFFFFFFFFFFFFFFFFFFFFFFFFFFFFFFFFWSSSSSSSSSSSSSSSSSS
WWWWWWPPPPPPPPWWFFFFFFFFWWWWWWWWWWWWWWWWWWWWWWWWWWWWWWSSSSSSSSSSSSSSSSSS
SSSSSWPPPPPPPPWWFFFFFFFFWSSSSSSSSSSSSSSSSSSSSSSSSSSSSSSSSSSSSSSSSSSSSSSS
SSSSSWWWWWWWWWWWWWWWWWWWWSSSSSSSSSSSSSSSSSSSSSSSSSSSSSSSSSSSSSSSSSSSSSSS
