DEFAULT
1,1
SSSSSSSSSSSSSSWWWSSSSSSSSSSSSSSSSSSS
SSSSSSSSSSSSSSWEWSSSSSSSSSSSSSSSSSSS
SSSSSSSSSSSSSSWFWSSSSSSSSSSSSSSSSSSS
SSSSSSSSSSSSSSWFWSSSSSSSSSWWWWSSSSSS
SSWWWWWSSWWWSSWFWSSSWWWSSWWFFWSSSSSS
SSWFFFWWWWFWWSWFWSSWWFWWWWFFFWSSSSSS
SWWFFFFWWFFFWWWFWWWWFFFWWFFFFWSSSSSS
WWFFFFFFFFFFFFFFFFFFFFFWWFFFFWWWSSSS
WFFFFFFFFFFFFFFFFFFFFFFFFFFFFFFWSSSS
WFFFFFFFFFFFFFFFFFFFFFFFFFFFFFFWWSSS
WFFFFFFFFFFFFFFFFFFFFFFFFFFFFFFFWSSS
WFFWWFFFFFFFFFFFFFFFFFFFFWWWFFFFWWWS
WFWWWFFFFFFFFFFFFFFFFFFFFWSWFFFFFFWS
WFWWWFFFFFFFFFWWWFFFFFFFFWWWFFFFWWWS
WFFFFFFFFFFFFFWWWFFFFFFFFFFFFFFFWSSS
WWWWWWFFFFFFFFWWFFFFFFFFFFFFFFFWWSSS
SSSSSWFFFFFFFFWWFFFFWWWWFFFFFFFWSSSS
SSSSSWFFFFFFFFFFFFFWWSSWFFFFFFWWSSSS
SSSSSWWFFFWWWFFFFFFWSSSWWFFFFWWSSSSS
SSSSSSWWWFWSWWWFFFWWSSSSWFFFFWSSSSSS
SSSSSSSSWFWSSSWFFFWSSSSSWWFFFWSSSSSS
SSSSSSSSWFWWWWWFFWWSSSSSSWWFFWSSSSSS
SSSSSSSSWFFFFFFFFWSSSSSSSSWFFWSSSSSS
SSSSSSSSWWWWWWWFWWSSSSSSSSWWWWSSSSSS
SSSSSSSSSSSSSSWFWSSSSSSSSSSSSSSSSSSS
SSSSSSSSSSSSSSWFWWWWSSSSSSSSSSSSSSSS
SSSSSSSSSSSSSSWFFFFWSSSSSSSSSSSSSSSS
SSSSSSSSSSSSSSWFFFFWSSSSSSSSSSSSSSSS
SSSSSSSSSSSSSSWFFFFWSSSSSSSSSSSSSSSS
SSSSSSSSSSSSSSWFWWWWSSSSSSSSSSSSSSSS
SSSSSSSSSSSSSSWFWSSSSSSSSSSSSSSSSSSS
SSSSSSSSSSSSSSWFWSSSSSSSSSSSSSSSSSSS
SSSSSSSSSSSSSSWFWSSSSSSSSSSSSSSSSSSS
WWWWWWWWWWWWWWWFWSSSSSSSSSSSSSSSSSSS
WFFFFFFFFFFFFFFFWSSSSSSSSSSSSSSSSSSS
WWWWWWWWWWWWWWWWWSSSSSSSSSSSSSSSSSSS
