DEFAULT
50,3
SSSSSSSSSSSSSSWWWSSSSSSSSSSSSSSSSSSSSSSSSSSSSSSSSSSSSSSSSSSSSSSSSSS
SSSSSSSSSSSSSSWEWSSSSSSSSSSSSSSSSSSSSSSSSSSSSSSSSSSSSSSSSSSSSSSSSSS
SSSSSSSSSSSSSSWFWSSSSSSSSSSSSSSSSSSSSSSSSSSSSSSSSSSSSSSSSSSSSSSSSSS
SSSSSSSSSSSSSSWFWSSSSSSSSSWWWWSSSSSSSSSSSSSSSSSSSSSSSSSSSSSSSSSSSSS
SSWWWWWSSWWWSSWFWSSSWWWSSWWFFWSSSSSSSSSSSSSSSSSSSSSSSSSSSSSSSSSSSSS
SSWFFFWWWWFWWSWFWSSWWFWWWWFFFWSSSSSSSSSSSSSSSSSSSSSSSSSSSSSSSSSSSSS
SWWFFFFWWFFFWWWDWWWWFFFWWFFFFWSSSSSSSSSSSSSSSSSSSSSSSSSSSSSSSSSSSSS
WWFFFFFFFFFFFFFFFFFFFFFWWFFFFWWWSSSSSSSSSSSSSSSSSSSSSSSSSSSSSSSSSSS
WFFFFFFFFFFFFFFFFFFFFFFFFFFFFFFWSSSSSSSSSSSSSSSSSSSSSSSSSSSSSSSSSSS
WFFFFFFFFFFFFFFFFFFFFFFFFFFFFFFWWSSSSSSSSSSSSSSSSSSSSSSSSSSSSSSSSSS
WFFFFFFFFFFFFFFFFFFFFFFFFFFFFFFFWSSSSSSSSSSSSSSSSSSSSSSSSSSSSSSSSSS
WFFWWFFFFFFFFFFFFFFFFFFFFWWWFFFFWWWSSSSSSSSSSSSSSSSSSSSSSSSSSSSSSSS
WFWWWFFFFFFFFFFFFFFFFFFFFWSWFFFFFFWSSSSSSSSSSSSSSSSSSSSSSSSSSSSSSSS
WFWWWFFFFFFFFFWWWFFFFFFFFWWWFFFFWWWSSSSSSSSSSSSSSSSSSSSSSSSSSSSSSSS
WFFFFFFFFFFFFFWWWFFFFFFFFFFFFFFFWSSSSSSSSSSSSSSSSSSSSSSSSSSSSSSSSSS
WWWWWWFFFFFFFFWWFFFFFFFFFFFFFFFWWSSSSSSSSSSSSSSSSSSSSSSSSSSSSSSSSSS
SSSSSWFFFFFFFFWWFFFFWWWWFFFFFFFWSSSSSSSSSSSSSSSSSSSSSSSSSSSSSSSSSSS
SSSSSWFFFFFFFFFFFFFWWSSWFFFFFFWWSSSSSSSSSSSSSSSSSSSSSSSSSSSSSSSSSSS
SSSSSWWFFFWWWFFFFFFWSSSWWFFFFWWSSSSSSSSSSSSSSSSSSSSSSSSSSSSSSSSSSSS
SSSSSSWWWFWSWWWFFFWWSSSSWFFFFWSSSSSSSSSSSSSSSSSSSSSSSSSSSSSSSSSSSSS
SSSSSSSSWFWSSSWFFFWSSSSSWWFFFWSSSSSSSSSSSSSSSSSSSSSSSSSSSSSSSSSSSSS
SSSSSSSSWFWWWWWFFWWSSSSSSWWFFWSSSSSSSSSSSSSSSSSSSSSSSSSSSSSSSSSSSSS
SSSSSSSSWFFFFFFFFWSSSSSSSSWFFWSSSSSSSSSSSSSSSSSSSSSSSSSSSSSSSSSSSSS
SSSSSSSSWWWWWWWFWWSSSSSSSSWWWWSSSSSSSSSSSSSSSSSSSSSSSSSSSSSSSSSSSSS
SSSSSSSSSSSSSSWFWSSSSSSSSSSSSSSSSSSSSSSSSSSSSSSSSSSSSSSSSSSSSSSSSSS
SSSSSSSSSSSSSSWFWWWWSSSSSSSSSSSSSSSSSSSSSSSSSSSSSSSSSSSSSSSSSSSSSSS
SSSSSSSSSSSSSSWFFFFWSSSSSSSSSSSSSSSSSSSSSSSSSSSSSSSSSSSSSSSSSSSSSSS
SSSSSSSSSSSSSSWFFFFWSSSSSSSSSSSSSSSSSSSSSSSSSSSSSSSSSSSSSSSSSSSSSSS
SSSSSSSSSSSSSSWFFFFWSSSSSSSSSSSSSSSSSSSSSSSSSSSSSSSSSSSSSSSSSSSSSSS
SSSSSSSSSSSSSSWFWWWWSSSSSSSSSSSSSSSSSSSSSSSSSSSSSSSSSSSSSSSSSSSSSSS
SSSSSSSSSSSSSSWFWSSSSSSSSSSSSSSSSSSSSSSSSSSSSSSSSSSSSSSSSSSSSSSSSSS
SSSSSSSSSSSSSSWFWSSSSSSSSSSSSSSSSSSSSSSSSSSWWWWWWWWWWWWWWWWWWWWSSSS
SSSSSSSSSSSSSSWFWSSSSSSSSSSSSSSSSSSSSSSSSSSWFFFFFFFFWWPPPPPPPPWSSSS
SSSSSSSSSSSSSSWFWWWWWWWWWWWWWWWWWWWWWWWWWWWWFFFFFFFFWWPPPPPPPPWWWWW
SSSSSSSSSSSSSSWFFFFFFFFFFFFFFFFFFFFFFFFFFFFFFFFFFFFFWWPPPPPPPPPPPPP
SSSSSSSSSSSSSSWWWWWWWWWWWWWWWWWWWWWWWWWWWWWWFFFFFFFFWWPPPPPPPPWWWWW
SSSSSSSSSSSSSSSSSSSSSSSSSSSSSSSSSSSSSSSSSSSWFFFFFFFFWWPPPPPPPPWSSSS
SSSSSSSSSSSSSSSSSSSSSSSSSSSSSSSSSSSSSSSSSSSWWWWWWWWWWWWWWWWWWWWSSSS
