DEFAULT
9.5,7.25
SSSSSSWWWWWWWWWWWWWWWWWWSSSSS
SSSSSSWFFFFFFFFFFFFFFFFWSSSSS
SSSSSSWFFFFFFFFFFFFFFFFWSSSSS
SSSSSSWFFFFFFFFFFFFFFFFWSSSSS
SSSSSSWFFFFFFFFFFFFFFFFWSSSSS
SSSSSSWFFFFFFFFFFFFFFFFWSSSSS
SSSSSSWFFFFFFFFFFFFFFFFWWWWWW
SSSSSSWFFFFFFFFFFFFFFFFFFFFEW
SWWWWWWFFFFFFFFFFFFFFFFWWWWWW
SWFFFFFFFFFFFFFFFFFFFFFWSSSSS
SWFFFFFFFFFFFFFFFFFFFFFWSSSSS
SWFFFFFFFFFFFFFFFFFFFFFWSSSSS
SWFFFFFFFFFFFFFFFFFFFFFWSSSSS
SWWWWWWWWWWWWWWWWWWWWWWWSSSSS
