DEFAULT
4,6
volume-bgm:9.0,7.0;volume-master:9.0,9.0;volume-sfx:9.0,5.0
SSWWWWWWWWWWWW
SSWFFFFFFFFFFW
SSWFFFFFFFFFFW
SSWFFFFFFFFFFW
WWWFFFFFFFFFFW
WEFFFFFFFFFFFW
WWWFFFFFFFFFFW
SSWFFFFFFFFFFW
SSWFFFFFFFFFFW
SSWFFFFFFFFFFW
SSWFFFFFFFFFFW
SSWWWWWWWWWWWW
