DEFAULT
5,8
6,9;12,17;34,14;
SSSSSSSSSSSSSSSSSSSSSSSSSSSSSSSSSSSWWWWWWWSSSSSSSSSSSSSSSSSSSSSSSSSSSS
SSSSSSSSSSSSSSSSSSSSSSSSSSSSSSSSSSSWHFFFHWSSSSSSSSSSSSSSSSSSSSSSSSSSSS
SSSSSSSSSSSSSSSSSSSSSSSSSSSSSSSSSSSWFFEFFWSSSSSSSSSSSSSSSSSSSSSSSSSSSS
SSSSSSSSSSSSSSSSSSSSSSSSSSSSSSSSSSSWFFFFFWSSSSSSSSSSSSSSSSSSSSSSSSSSSS
SSSSSSSSSSSSSSSSSSSSSSSSSSSSSSSSSSSWFFFFFWSSSSSSSSSSSSSSSSSSSSSSSSSSSS
SSSSSSSSSSSSSSSSSSSSSSSSSSSSSSSSSSSWWFFFWWSSSSSSSSSSSSSSSSSSSSSSSSSSSS
SSSWWWWWWWWSSSSSSSSSSSSSSSSSSSSSSSSSWFFFWSSSSSSSSSSSSSSSSSSSSSSSSSSSSS
SSSWFFFFFFWSSSSSSSSSSSSSSSSSSSSSSSSSWFFFWSSSSSSSSSSSSSSSSSSSSSSSSSSSSS
SSSWFFFFFFWSSSSSSSSSSSSSSSSSSSWWWWWWWFFFWWWWWWWWWWWWWWWWWWWWWSSSSSSSSS
SSSWFFFFFFWSSSSSSSSSSSSSSSSSSSWPPPPPPPFPPPPPPPPPPPPPPPPPPHHHWSSSSSSSSS
SSSWFFFFFFWSSSSSSSSSSSSSSSSSSSWPPPPPPPFPPPPPPPPPPPPPPPPPPFFFWSSSSSSSSS
SSSWFFFFFFWSSSSSSSSSSSSSSSSSSSWPPPFFFFFPPPPPPPPPPPPPFFFFFFFFWSSSSSSSSS
SSSWWWWWFWWSSSSSSSSSSSSSSSSSSSWPPPFPPPPPPPPPPPPPPPPPPPPPPFFFWSSSSSSSSS
SSSWWWWWFWWSSSSSSSSSSSSSSSSSSSWPPPFPPPPPPPPPPPPPPPPPPPPPPHHHWSSSSSSSSS
SSSWHHFFFWWSWWWWWWWWWWWWWWWWWWWWWWFWWWWWWWWWWWWWWWWWWWWWWWWWWSSSSSSSSS
SSSWWWWWFWSSWFFFFFFFFFFHHHWFFFFFFFFFFFWSSSSSSSSSSSSSSSSSSSSSSSSSSSSSSS
SSSSSSSWFWWWWFFFFFFFFFFFHHWFFFFFFFFFFFWSSSSSSSSSSSSSSSSSSSSSSSSSSSSSSS
SSSSSSSWFHFFDFFFFFFFFFFFFFWFFFFFFFFFFHWSSSSSSSSSSSSSSSSSSSSSSSSSSSSSSS
SSSSSSSWFHFWWFFFFFFFFFFFFFWFFFFFFFFFHHWSSSSSSSSSSSSSSSSSSSSSSSSSSSSSSS
SSSSSSSWFFFWWFFFFFFFFFFFFFWFFFFFFFFHHHWSSSSSSSSSSSSSSSSSSSSSSSSSSSSSSS
SSSSSSSWWWWWWHFFFFFFFFFFFFFFFFFFFFHHHHWSSSSSSSSSSSSSSSSSSSSSSSSSSSSSSS
SSSSSSSSSSSSWHHHFFFFFFFFFFWFFFFFFHHHHHWSSSSSSSSSSSSSSSSSSSSSSSSSSSSSSS
SSSSSSSSSSSSWWWWWWWWWWWWWWWWWWWWWWWWWWWSSSSSSSSSSSSSSSSSSSSSSSSSSSSSSS
